xxxxxxxxxxxxx
P---x---x---x
x---x---x---G
x--xx-------x
xT--x---x---x
xx--xx--x--xx
x-------x---x
xxxxxxxxxxxxx
